GGGGGGGGGppGGGGGGGGG
GGGGGGGGGppGGGGGGGGR
RRRRRRRRRbbRRRRRRRRR
GRRRRRRRRRRRRRRRRRRG
GGGRRRRRRbbRRRRRRRGG
MMMGGGGGGppGGGGGGGGG
MMGGGGGGGppGGGGGGGGG
GGGGGGGGppGGGGGGGGMM
GGGGGGGppGGGGGGMMMMM
GGGGGGppGGGGMMMMMMMM